{
  "name":"World I",
  "sizex":16,
  "sizey":16,
  "tileset":"tileset1.json",
  "tiles":[
    0,1,2,3,4,5,2,3,0,1,2,3,4,5,2,3,
    0,1,2,3,0,4,2,3,0,1,2,3,0,4,2,3,
    0,1,2,3,0,1,2,3,0,1,2,3,0,1,2,3,
    0,1,2,3,0,5,2,3,0,1,2,3,0,5,2,3,
    0,1,2,3,0,2,2,3,0,1,2,3,0,2,2,3,
    0,1,2,3,0,3,2,3,0,1,2,3,0,3,2,3,
    0,1,2,3,0,4,2,3,0,1,2,3,0,4,2,3,
    0,1,2,3,0,1,2,0,0,1,2,3,0,1,2,0,
    0,1,2,3,4,5,2,3,0,1,2,3,4,5,2,3,
    0,1,2,3,0,4,2,3,0,1,2,3,0,4,2,3,
    0,1,2,3,0,1,2,3,0,1,2,3,0,1,2,3,
    0,1,2,3,0,5,2,3,0,1,2,3,0,5,2,3,
    0,1,2,3,0,2,2,3,0,1,2,3,0,2,2,3,
    0,1,2,3,0,3,2,3,0,1,2,3,0,3,2,3,
    0,1,2,3,0,4,2,3,0,1,2,3,0,4,2,3,
    0,1,2,3,0,1,2,0,0,1,2,3,0,1,2,0
  ],
  "entities":[]
}